R   1600 900

NO  ./srcs/no_tile.xpm 
SO  ./srcs/so_tile.xpm
WE  ./srcs/we_tile.xpm
EA  ./srcs/ea_tile.xpm


        1111111111111111111111111          
        1000000000110000000000001          
        1011000001110000002000001          
        1001000000000000000000001          
111111111011000001110000000000001          
100000000011000001110111111111111          
1111011111111101110000001000111111111111111
111101111111110111010100N0001              
1100000011010101110000001000111111111111111
1000200000000000110000001000111111111111111
1000000000000000110101001000000000000000001
1100000111010101111101111000111111111111111
11110111 1110101 101111010001              
11111111 1111111 111111111111