R   1600 900

NO  ./srcs/no_tile.xpm 
SO  ./srcs/so_tile.xpm
WE  ./srcs/we_tile.xpm
EA  ./srcs/ea_tile.xpm
S   ./srcs/guard.xpm
S1  ./srcs/officer.xpm

F   77,60,47
C   13,71,161

  111                                                   1111111111111111111111111111111111111111111
  101                                                   10000000000000000000000000000000001000000011
  111                                                   100000000000000000000000000000000000000000011
                                                        1000000000000000000000000000000000000000000011
              1111111  111111111111111111111            10000000000000000000000000000000000000000000011
           1111100001  100011111000000001001            10000000000000000000000000000000000000000000011
        1111100000001  100000011110111111101            100000000000000000000000000200000000000000000011
  1111111100000000001  10000000000011    11             1000000000000000000000000000000000000000000000011
  1000000000000000001  10000000000111   11011111111     10000000000000000000000000000000000000000000000011
  1100000000000000001  10000000000001   11000000001     100000000000000000000000000000000000000000000000011
  1111111101111111111  11111110111111   11111111101     100000000000W000000000000000000000000000000000000011
         101                10001               101     100000000000000000000000001000000000000000000000000011
  11111111011111111     111110001111111111111   101111  1000000000000000000000000111000000000000000000000000011
 111000000000000011    1100000000000000000001   100001  10000000000000000000000011 110000000000000000000000000111
  10000000000000001    1000000000000000000001   1100011 1000000000000000000000011   11000000000000000000000000011
  11000000000000011    1100000000000111110001   1000001 10000000000000000000000011 11000000000000000000000000011
  1000000000000001      1000000000001   10001   1000001 1000000000000000000000000111000000000000000000000000011
  11100000000000011111111000000000001   10001   11000011102222222222222222222222221000000000000000000000000011
   1111000000000000001000000000000001   10001  11100000000000000000000000000000000000000000000000000000000011
   11000000000000000000000000001111111   11111  100011111022222222222222222222222200000000000000000000000011
   11111000001100000010100000000001            10001    100000000000000000000000000000000000000000000000011
 111000000000000000000000000001111111111111111110001    10000000000000000000000000000000000000000000000011
 111111000000000000000000000000000000000000000000001    10000000000000000000000000000000000000000000000011
     11111100000000000000000011111111111111111000001    100000000000000000000000000000000000000000000011
         1111110000000000111111            111111111    100000000000000000000000000000000000000000000011
             111111111111                               10000000000000000000000000000000000000000000001
                                                        10000000000000000000000000000000000000000000001
                                                        1000000000000000000000000000000000000000000111
                                                        1111111111111111111111111111111111111111111